{
  "en": "🇬🇧",
  "fr": "🇫🇷",
  "es": "🇪🇸",
  "de": "🇩🇪",
  "it": "🇮🇹",
  "ja": "🇯🇵",
  "ko": "🇰🇷",
  "zh-Hans": "🇨🇳",
  "ru": "🇷🇺",
  "es-MX": "🇲🇽",
  "pt": "🇵🇹",
  "nl": "🇳🇱",
  "tr": "🇹🇷",
  "ar": "🇸🇦",
  "th": "🇹🇭",
  "vi": "🇻🇳",
  "pl": "🇵🇱",
  "sv": "🇸🇪",
  "da": "🇩🇰",
  "no": "🇳🇴",
  "fi": "🇫🇮",
  "el": "🇬🇷",
  "id": "🇮🇩",
  "ms": "🇲🇾",
  "fil": "🇵🇭",
  "hu": "🇭🇺",
  "cs": "🇨🇿",
  "sk": "🇸🇰",
  "ro": "🇷🇴",
  "uk": "🇺🇦",
  "hr": "🇭🇷",
  "bg": "🇧🇬",
  "et": "🇪🇪",
  "lv": "🇱🇻",
  "lt": "🇱🇹",
  "sl": "🇸🇮",
  "mt": "🇲🇹",
  "sq": "🇦🇱",
  "mk": "🇲🇰",
  "bs": "🇧🇦",
  "sr": "🇷🇸",
  "cy": "🇨🇾",
  "ga": "🇮🇪",
  "gd": "🏴",
  "kw": "🇰🇾",
  "br": "🇧🇷",
  "af": "🇿🇦",
  "xh": "🇿🇦",
  "zu": "🇿🇦",
  "tn": "🇿🇦",
  "st": "🇿🇦",
  "ss": "🇿🇦",
  "nr": "🇿🇦",
  "nso": "🇿🇦",
  "ts": "🇿🇦",
  "ve": "🇿🇦",
  "xog": "🇺🇬",
  "lg": "🇺🇬",
  "ak": "🇬🇭",
  "tw": "🇬🇭",
  "bm": "🇧🇫",
  "my": "🇲🇲",
  "km": "🇰🇭",
  "lo": "🇱🇦",
  "am": "🇪🇹",
  "ti": "🇪🇹",
  "om": "🇪🇹",
  "so": "🇸🇴",
  "sw": "🇰🇪",
  "rw": "🇷🇼",
  "yo": "🇳🇬",
  "ig": "🇳🇬",
  "ha": "🇳🇬",
  "bn": "🇧🇩",
  "pa": "🇮🇳",
  "gu": "🇮🇳",
  "or": "🇮🇳",
  "ta": "🇮🇳",
  "te": "🇮🇳",
  "kn": "🇮🇳",
  "ml": "🇮🇳",
  "si": "🇱🇰",
  "ne": "🇳🇵",
  "dz": "🇧🇹",
  "be": "🇧🇾",
  "kk": "🇰🇿",
  "uz": "🇺🇿",
  "ky": "🇰🇬"
}